      11111111111111111111111111
    11100000000000001     1000011111
111110000000001111111     1000000001
100000000000001       11111000000011
100000000000001111111110001111111111
111111000000000000000000011
    1100000000000000000001
    100000001     10000001
    100000011     10000011
    111111111     1111111