R 1000 1000

NO     ./img/xp1.xpm   
SO   ./img/cartoon.xpm
S ./img/barrel.xpm


EA ./img/bricks.xpm


WE ./img/xp4.xpm
C 22 , 0 , 255

F  100  , 255, 255

1111111111111111111111
1000000000110000000001111
10110000000N0000000000001
1001000000000000000000001
1111111111111111111111111
