R 1920 1080

NO     ./img/grass.xpm
SO   ./img/neon.xpm
S ./img/barrel.xpm

EA ./img/bricks.xpm

WE ./img/craft.xpm
C 56, 13, 2
F 2, 2, 4

11111111
10000001
10000001
100S0001
10000001
10000021
11111111
