R 1920 1000

NO     ./img/grass.xpm   
SO   ./img/neon.xpm
S ./img/barrel.xpm

EA ./img/bricks.xpm

WE ./img/craft.xpm
C 56, 13, 0
F 0, 3, 41

11111111111111111111111111111111111111111111111111111111111111111111111111111111
1000000000S020000000100000000000000000000000000000000000000000000000000000000001
10000200011000000000100000000000000000000000000000000000000000000000000000000001
10000000111000000000100000000000000000000000010000000000000000000000000000000001
11111111111011111111100000000000001000000000010000000000002000000000011000000001
10000000000000000000100000000000001000000000010000000000000000000000000000000001
10000000000000000000100000000000001000000000010000000000000000000000000000000001
10000000000000000000100000000000001000000000010000000000000000000000000010000001
10000000000000000000100000000000001000000000010000000000000001000000000010000001
10000000100000000000100000000000001000000000010000000000000000000000000000000001
10000000000000000000100000000000001000000000010000000000000000000000000000000001
10000000000000000000100000000000001000000000000000000011000000000000000000000001
10000000000000000000111111111111111000000000000000000000000000000000000000000001
10000000000000000000000000000000000000000000000000000000000000000000001000000001
10000000000000000000000000000000000000000200000000000000000010000000000000000001
10000000000000011000000000000000000000000000010000000000000000000000000000000001
10000000000000000000000000020000000000000000000000000000000000000000000000000001
10000000000000000000000000000000000000000000000010000000000100000000000000000001
10000000000000000000000000000000000000000000000000000000000000000000000000000001
10000000000000000000000000000000000000000000000001000000000000000000000000000001
10000000000000011111111110011111111100000200000000000000000000000000000000000001
10000001000000010000000000000000000100000000000000000100000000000200000000000001
10000000000000010100000111110000000100000000000000000000000000000000000000000001
100000000000000100000001   10001000100000000000000000000000000000000000000000001
100000000000000101000001   10000000100000000000000000100000000000000000000000001
10000000000000010000000111110000000100000000000000001110000000000000010000000001
10020000000000010000000000100000000100000000000000000100000000000000000000000001
10000000000000011111111111111111111100000000000000000000000000000000000000000001
10000000010111110000000000000000000000000000000000000000000000000000000000000001
10000000010000000000000000000000000000000000000000000000000000000000000000000001
10000000010000000000000000000000000000000000000000000000000000000000000000000001
10000000010000000000000000000000000000000000000000010000000100000000100000000001
10000000010000000000000000000000000000000000000011100000000000000000000000000001
10000000010000000000000000000000110000000000000000000000000000000000000000000001
10000000010000000000000000000000011100000000000000000000000000000000000000000001
10000000010000000000000000000000000000000000000000000000000000000000000000000001
11111111111111111111111111111111111111111111111111111111111111111111111111111111