R 1000 1000

NO     ./img/xp1.xpm   
SO   ./img/cartoon.xpm
S ./img/barrel.xpm


EA ./img/bricks.xpm


WE ./img/xp4.xpm
C 0, 255, 0

F  100  , 255, 255

1111111111111111111111
1000000000001000000001111
1011000000000000000000001
1011000001000000000000001
1011000000000100000000001
1011000000000000000000001
1011000000000000000000001
10010000000N0000000000001
1111111111111111111111111
