R  10001 1001

NO     ./img/grass.xpm
SO   ./img/neon.xpm
S ./img/barrel.xpm

EA ./img/bricks.xpm

WE ./img/craft.xpm
C 56, 4294967395, 2
F 2, 2, 4

111111111
100000001
100000001
1000S0001
100000001
100000021
111111111
