R 1920 1000

NO     ./img/xp1.xpm   
SO   ./img/cartoon.xpm
S ./img/barrel.xpm


EA ./img/bricks.xpm


WE ./img/xp4.xpm
C 0, 255, 0

F  0, 0, 255


11111111111
10000000001
10000000001
10000000001
10000S00011
10000000001
10000000001
10000100001
11111111111