R 1920 1000

NO     ./img/xp1.xpm   
SO   ./img/cartoon.xpm
S ./img/barrel.xpm


EA ./img/bricks.xpm


WE ./img/xp4.xpm
C 0, 255, 0

F  0, 0, 255

1111111111111111111111111
1000000000000010000000001
1000000100000000010000001
1000000000000000000000001
100000000000S000001000001
1000000100000000000000001
1000000000001000000000001
1000000000000000000000001
1111111111111111111111111
