R 1000 100

NO     ./img/xp1.xpm   
SO   ./img/cartoon.xpm
S ./img/barrel.xpm


EA ./img/bricks.xpm


WE ./img/xp4.xpm
C 22 , 0 , 255

F  100  , 255, 255

      1111111111111111111111111
      10000000000000000000000011111
      10000000000000111111100000001
    11100000000000001     1000000111
111110000000001111111     1000000001
100000000000001       11111000000011
10000000000000111111111000111111111
111111000000000000000000011
    1100000000000000000001
    10000000111111100E0001
    100000011     10000011
    111111111     1111111
