R 0000000000000000001920 0000000000001080  

NO     ./img/barrel.xpm     
SO  ./img/mario.xpm   
S ./img/mario.xpm

EA ./img/bricks.xpm
   
WE ./img/eagle.xpm

C 56, 13, 2
F 2, 3, 41

1111111
1210001
1000001
1000001
1000001
1000001
1000001
1000001
100N001
1111111