R  1920 1080

NO ./img/bricks.xpm
SO ./img/neon.xpm
WE ./img/grass.xpm
EA ./img/eagle.xpm

S ./img/barrel.xpm


C 56, 13, 0
F 0, 3, 41


11111111111111111111111111111111111111111111111111111111111111111111111111111111
1222222222W022222222122222222222222222222222222222222222222222222222222222222221
12222222211022222222122222222222222222222222222222222222222222222222222222222221
12222222111022222222122222222222222222222222212222222222222222222222222222222221
11111111111011111111122222222222221222222222212222222222222222222222211222222221
12222222222022222222122222222222221222222222212222222222222222222222222222222221
12222222222022222222122222222222221222222222212222222222222222222222222222222221
12222222222022222222122222222222221222222222212222222222222222222222222212222221
12222222222022222222122222222222221222222222212222222222222221222222222212222221
12222222122022222222122222222222221222222222212222222222222222222222222222222221
12222222222022222222122222222222221222222222212222222222222222222222222222222221
12222222222022222222122222222222221222222222222222222211222222222222222222222221
12222222222022222222111111111111111222222222222222222222222222222222222222222221
12222222222022222222222222222222222222222222222222222222222222222222221222222221
12222222222022222222222222222222222222222222222222222222222212222222222222222221
12222222222022211222222222222222222222222222212222222222222222222222222222222221
12222222222022222222222222222222222222222222222222222222222222222222222222222221
12222222222022222222222222222222222222222222222212222222222122222222222222222221
12222222222022222222222222222222222222222222222222222222222222222222222222222221
12222222222022222222222222222222222222222222222221222222222222222222222222222221
12222222222022211111111112211111111122222222222222222222222222222222222222222221
12222221222022212222222222222222222122222222222222222122222222222222222222222221
12222222222022212122222111112222222122222222222222222222222222222222222222222221
122222222222222122222221   12221222122222222222222222222222222222222222222222221
122222222222222121222221   12222222122222222222222222122222222222222222222222221
12222222222222212222222111112222222122222222222222221112222222222222212222222221
12222222222222211111111111111111111122222222222222222222222222222222222222222221
12222222222222222222222222222222222222222222222222222222222222222222222222222221
12222222222222222222222222222222222222222222222222222222222222222222222222222221
12222222222222222222222222222222222222222222222222222222222222222222222222222221
12222222222222222222222222222222222222222222222222222222222222222222222222222221
12222222222222222222222222222222222222222222222222222222222222222222222222222221
12222222222222222222222222222222222222222222222222222222222222222222222222222221
12222222222222222222222222222222222222222222222222222222222222222222222222222221
12222222222222222222222222222222222222222222222222222222222222222222222222222221
12222222222222222222222222222222222222222222222222222222222222222222222222222221
12222222222222222222222222222222222222222222222222222222222222222222222222222221
12222222222222222222222222222222222222222222222222222222222222222222222222222221
12222222222222222222222222222222222222222222222222222222222222222222222222222221
12222222222222222222222222222222222222222222222222222222222222222222222222222221
12222222222222222222222222222222222222222222222222222222222222222222222222222221
12222222222222222222222222222222222222222222222222222222222222222222222222222221
12222222222222222222222222222222222222222222222222222222222222222222222222222221
12222222222222222222222222222222222222222222222222222222222222222222222222222221
12222222222222222222222222222222222222222222222222222222222222222222222222222221
12222222222222222222222222222222222222222222222222222222222222222222222222222221
12222222222222222222222222222222222222222222222222222222222222222222222222222221
12222222222222222222222222222222222222222222222222222222222222222222222222222221
12222222222222222222222222222222222222222222222222222222222222222222222222222221
12222222222222222222222222222222222222222222222222222222222222222222222222222221
12222222222222222222222222222222222222222222222222222222222222222222222222222221
12222222222222222222222222222222222222222222222222222222222222222222222222222221
12222222222222222222222222222222222222222222222222222222222222222222222222222221
12222222222222222222222222222222222222222222222222222222222222222222222222222221
12222222222222222222222222222222222222222222222222222222222222222222222222222221
12222222222222222222222222222222222222222222222222222222222222222222222222222221
12222222222222222222222222222222222222222222222222222222222222222222222222222221
12222222222222222222222222222222222222222222222222222222222222222222222222222221
12222222222222222222222222222222222222222222222222222222222222222222222222222221
12222222222222222222222222222222222222222222222222222222222222222222222222222221
12222222222222222222222222222222222222222222222222222222222222222222222222222221
12222222222222222222222222222222222222222222222222222222222222222222222222222221
12222222222222222222222222222222222222222222222222222222222222222222222222222221
12222222222222222222222222222222222222222222222222222222222222222222222222222221
12222222222222222222222222222222222222222222222222222222222222222222222222222221
12222222222222222222222222222222222222222222222222222222222222222222222222222221
12222222222222222222222222222222222222222222222222222222222222222222222222222221
12222222222222222222222222222222222222222222222222222222222222222222222222222221
12222222222222222222222222222222222222222222222222222222222222222222222222222221
12222222222222222222222222222222222222222222222222222222222222222222222222222221
12222222222222222222222222222222222222222222222222222222222222222222222222222221
12222222222222222222222222222222222222222222222222222222222222222222222222222221
12222222222222222222222222222222222222222222222222222222222222222222222222222221
12222222222222222222222222222222222222222222222222222222222222222222222222222221
12222222222222222222222222222222222222222222222222222222222222222222222222222221
12222222212222222222222222222222222222222222222222222222222222222222222222222221
12222222212222222222222222222222222222222222222222222222222222222222222222222221
12222222212222222222222222222222222222222222222222212222222122222222122222222221
12222222212222222222222222222222222222222222222211122222222222222222222222222221
12222222212222222222222222222222112222222222222222222222222222222222222222222221
12222222212222222222222222222222211122222222222222222222222222222222222222222221
12222222212222222222222222222222222222222222222222222222222222222222222222222221
11111111111111111111111111111111111111111111111111111111111111111111111111111111