R 1920 1000

NO     ./img/grass.xpm   
SO   ./img/me.xpm
S ./img/barrel.xpm

EA ./img/bricks.xpm

WE ./img/craft.xpm
C 56, 13, 0
F 0, 3, 41

1111111111111
1000002000001
1000002000001
1000002000001
100000S000001
1000002000001
1000002000001
1200002000021
1111111111111
