R 1000 100

NO     ./img/xp1.xpm   
SO   ./img/cartoon.xpm
S ./img/barrel.xpm


EA ./img/bricks.xpm


WE ./img/xp4.xpm
C 22 , 0 , 255

F  100  , 255, 255

11111
11E111
111