R  1920 1080

NO ./img/bricks.xpm

SO ./img/neon.xpm
WE ./img/grass.xpm
EA ./img/eagle.xpm

S ./img/barrel.xpm

C 56, 13, 0
F 0, 3, 41

11111111111111111111111111111111111111111111111111111111111111111111111111111111
10000000000020000000100000000000000000000000000000000000000000000000000000000001
10000200011000000000100000000000000000000000000000000000000000000000000000000001
10000000111000000000100000000000000000000000010000000000000000000000000000000001
11111111111011111111100000000000001000000000010000000000002000000000011000000001
10000000000000000000100000000000001000000000010000000000000000000000000000000001
10000000000000000000100000000000001000000000010000000000000000000000000000000001
10000000000000000000100000000000001000000000010000000000000000000000000010000001
10000000000000000000100000000000001000000200010000000000000001000000000010000001
10000000100000000000100000000000001000000000010000000000000000000000000000000001
10000000000000000000100000000000001000000020010000000000000000000000000000000001
10000000000000000000100000000000001000000000000000000011000000000000000000000001
10000000000000000000111111111111111000200000000000000000000000000000000000000001
10000000000000000000000000000000000000200002000000020000000000000000001000000001
10000000200000000000000000000200000000000200000000000000000010000000000000000001
10000000000000011000000000000000000000000000010000000000000000000000000000000001
10011100000000000000000000020000000020000000000000000000000000000000000000000001
1001 100000200000000200000000000000000000000000010000000000100000000000000000001
1001 1000000000000000000000N0000000002000000000000000000000000000000000000000001
1001 100000000000000000000000000000000000000000001000000000000000000000000000001
1001 100000000011111111110011111111100000200000000000000000000000000000000000001
10011101000000010000000000000000000100000000000000000100000000000200000000000001
10000000000000010100000111110000000100000002000000000000000000000000000000000001
100000000000000100000001   10001000100000000000000000000000000000000000000000001
100000000000000101000001   10000000100000020000000000100000000000000000000000001
10000000000000010000000111110000000100000000000000001110000000000000010000000001
10020000000000010000000000100000000100000000000000000100000000000000000000000001
10000000000000011111111111111111111100000000020000000000000000000000000000000001
10000000010111110000000000000000000000000000000000000000000000000000000000000001
10000000010000000000000000000000000000000000000000000000000000000000000000000001
10000000010000000000000000000000000000000000000000000000000000000020000000000001
10000000010000000000000000000000000000000000000000010000000100000000100000000001
10000000010000000000000000000000000000000000000011100000000000000000000000000001
10000000010000000000000000000000110000000000000000000000000000000000000000000001
10000000010000000000000000000000011100000000000000000000000000000000000000000001
10000000010000000000000000000000000000000000000000000000000000000000000000000001
11111111111111111111111111111111111111111111111111111111111111111111111111111111